11111111111111111111111111111111111111111111111111000000000000000000000000001111111111111111111111110000000000000000000000000000
11111111111111111111111111111111111111111111111111100000000000000000000000001111111111111111111111110000000000000000000000000000
11111111111111111111111111111111111111111111111111000000000000000000000000001111111111111111111111110000000000000000000000000000
11111111111111111111111111111111111111111111111110000000000000000000000000001111111111111111111111100000000000000000000000000000
11111111111111111111111111111111111111111111111100000000000000000000000000001111111111111111111110000000000000000000000000000000
11111111111111111111111111111111111111111111111100000000000000000000000000001011111111111111111000000000000000000000000000000000
11111111111111111111111111111111111111111111111100000000000000000000000000000111111111111111100000000000000000000000000000000000
11111111111111111111111111111111111111111111111100000000000000000000000000000111111111111111000000000000000000000000000000000000
11111111111111111111111111111111111111111111111000000000000000000000000000000111111111111111000000000000000000000000000000000000
11111111111111111111111111111111111111111111111000000000000000000000000000000011111111111000000000000000000000000000000000000000
11111111111111111111111111111111111111111111111100000000000000000000000000000011111111110000000000000000000000000000000000000000
11111111111111111111111111111111111111111111111100000000000000000000000000000011111111100000000000000000000000000000000000000000
11111111111111111111111111111111111111111111111111111000000000000000000000000001111111100000000000000000000000000000000000000000
11111111111111111111111111111111111111111111111111111100000000000000000000000000000000000000000000000000000000000000000000000000
11111111111111111111111111111111111111111111111111111100000000000000000000000000000000000000000000000000000000000000000000000000
11111111111111111111111111111111111111111111111111111110000000000000000000000000000000000000000000000000000000000000000000000000
11111111111111111111111111111111111111111111111111111111100000000000000000000000000000000000000000000000000000000000000000000000
11111111111111111111111111111111111111111111111111111111100000000000000000000000000000000000000000000000000000000000000000000000
11111111111111111111111111111111111111111111111111111111110000000000000000000000000000000000000000000000000000000000000000000000
11111111111111111111111111111111111111111111111111111111111110000001110000000000000000000000000000000000000000000000000000000000
11111111111111111111111111111111111111111111111111111111111111111111111111000000000000000000000000000000000000000000000000000000
11111111111111111111111111111111111111111111111111111111111111111111111111110000000000000000000000000000000000000000000000000000
11111111111111111111111111111111111111111111111111111111111111111111111111111000000000000000000000000000000000000000000000000000
11111111111111111111111111111111111111111111111111111111111111111111111111111000000000000000000000000000000000000000000000000000
11111111111111111111111111111111111111111111111111111111111111111111111111111000000000000000000000000000000000000000000000000000
11111111111111111111111111111111111111111111111111111111111111111111111111111110000000000000000000000000000000000000000000000000
11111111111111111111111111111111111111111111111111111111111111111111111111111111111000000000000000000000000000000000000000000000
11111111111111111111111111111111111111111111111111111111111111111111111111111111111111000000000000000000000000000000000000000000
11111111111111111111111111111111111111111111111111111111111111111111111111111111111111100000000000000000000000000000000000000000
11111111111111111111111111111111111111111111111111111111111111111111111111111111111111100000000000000000000000000000000000000000
11111111111111111111111111111111111111111111111111111111111111111111111111111111111111100000000000000000000000000000000000000000
11111111111111111111111111111111111111111111111111111111111111111111111111111111111111110000000000000000000000000000000000000000
11111111111111111111111111111111111111111111111111111111111111111111111111111111111111111000000000000000000000000000000000000000
11111111111111111111111111111111111111111111111111111111111111111111111111111111111111111100000000000000000000000000000000000000
11111111111111111111111111111111111111111111111111111111111111111111111111111111111111111100000000000000000000000000000000000000
11111111111111111111111111111111111111111111111111111111111111111111111111111111111111111111000000000000000000000000000000000000
11111111111110000011001111111111111111111111111111111111111111111111111111111111111111111111000000000000000000000000000000000000
11111111111000000000000111111111111111111111111111111111111111111111111111111111111111111111101111000000000000000000000000000000
11111111111100000000001111111111111111111111111111111111111111111111111111111111111111111111000111000000000000000000000000000000
11111111111000000000001111111111111111111111111111111111111111111111111111111111111111111111000000010000000000000000000000000000
11111111110000000000001111111111111111111111111111111111111111111111111111111111111001000111110000000000000000000000000000000000
11111111000000000000001111111111111111111111111111111111111111111111111111111111111000000000010000000000000000000000000000000000
11111000000000000000001111111111111111111111111111111111111111111111111111111111111000000000000000000000000000000000000000000000
11110000000000000000000111111111111111111111111111111111111111111111111111111111111100000000000000000000000000000000000000000000
11100000000000000000000111111111111111111111111111111111111111111111111111111111111100000000000000000000000000000000000000000000
11111000000000000000000111111111111111111111111111111111111111111111111111111111111110000000000000000000000000000000000000000000
11111111100000000000000011111111111111111111111111111111111111111111111111111111111110000000000000000000000000000000000000000000
11111111100000000000000011011111111111111111111111111111111111111111111111111111111111000000000000000000000000000000000000000000
11111111100000000000000000011111111111111111111111111111111111111111111111111111111111000000000000000000000000000000000000000000
11111111100000000000000000011111111111111111111111111111111111111111111111111111111111000000000000000000000000000000000000000000
11111111100000000000000010111111111111111100000111000001111111111111111111111111111111100000000000000110000000000000000000000000
11111111110000000000000011111111111111111000000000000000111111111111111111111111111111110000000000111110000000000000000000000000
11111111111000000000000011111111111111111000000000000000011111111111111111111111111111111100000000111111000000000000000000000000
11111111000000000000000001111111111111110000000000000000000111111111111111111111111111111100000001111111000000000000000000000000
11111110000000000000000001111111111111100000000000000000000011111111111111111111111111111100000101111111111000000000000000000000
11111000000000000000000000011111111111100000000000000000000000111111111111111111111111111110000001111111111100100000000000000000
00110000000000000000000000001111111111000000000000000000000000000111111111111111111111111111000011111111111111110000000000000000
00000000000000000000000000011111111111000000000000000000000000000111111111111111111111111110001111111111111111111000000000000000
00000000000000000000000000011111111110000000000000000000000000000011111111111111111111111111111111111111111111111000000000000000
00000000000000000000000000011111111110000000000000000000000000000011111111111111111111111111111111111111111111111000000000000000
00000000000000000000000000011111110000000000000000000000000000000011111111111111111111111111111111111111111111111000000000000000
00000000000000000000000000111111000000000000000000000000000000000001111111111111111111111111111111111111111111111000000000000000
00000000000000000000000000011110000000000000000000000000000000000001111111111111111111111111111111111111111111111000000000000001
00000000000000000000000000000000000000000000000000000000000000000001111111111111111111111111111111111111111111111100000000000011
00000000000000000000000000000000000000000000000000000000000000000000111111111111111111111111111111111111111111111110000000000011
00000000000000000000000000000000000000000000000000000000000000000000111111111111111111111111111111111111111111111111000000000011
00000000000000000000000000000000000000000000000000000000000000000000111111111111111111111111111111111111111111111111000000001111
00000000000000000000000000000000000000000000000000000000000000000000011111111111111111111111111111111111111111111111000000011111
00000000000000000000000000000000000000000000000000000000000000000000011111111111111111111111111111111111111111111111110000011111
00000000000000000000000000000000000000000000000000000000000000000000001111111111111111111111111111111111111111111111111001111111
00000000000000000000000000000000000000000000000000000000000000000000000111111111111111111111111111111111111111111111111111111111
00000000000000000000000000000000000000000000000000000000000000000000000111111111111111111111111111111111111111111111111111111111
00000000000000000000000000000000000000000000000000000000000000000000000011111111111111111111111111111111111111111111111111111111
00000000000000000000000000000000000000000000000000000000000000000000000011111111111111111111111111111111111111111111111111111111
00000000000000000000000000000000000000000000000000000000000000000000000011111111111111111111111111111111111111111111111111111111
00000000000000000000000000000000000000000000000000000000000000000000000001111111111111111111111111111111111111111111111111111111
00000000000000000000000000000000000000000000000000000000000000000000000001111111111111111111111111111111111111111111111111111111
00000000000000000000000000000000000000000000000000000000000000000000000001111111111111111111111111111111111111111111111111111111
00000000000000000000000000000000000000000000000000000000000000000000000000111111111111111111111111111111111111111111111111111111
00000000000000000000000000000000000000000000000000000000000000000000000000111111111111111111111111111111111111111111111111111111
00000000000000000000000000000000000000000000000000000000000000000010000000111111111111111111111111111111111111111111111111111111
00000000000000000000000000000000000000000000000000000000000000000111000001111111111111111111111111111111111111111111111111111111
00000000000000000000000000000000000000000000000000000000000000000111000011111111111111111111111111111111111111111111111111111111
00000000000000000000000000000000000000000000000000000000000000001111100011111111111111111111111111111111111111111111111111111111
00000000000000000000000000000000000000000000000000000000000000001111111111111111111111111111111111111111111111111111111111111111
00000000000000000000000000000000000000000000000000000000011111111111111111111111111111111111111111111111111111111111111111111111
00000000000000000000000000000000000000000000000000000000111111111111111111111111111111111111111111111111111111111111111111111111
00000000000000000000000000000000000000000000000000000001111111111111111111111111111111111111111111111111111111111111111111111111
00000000000000000000000000000000000000000000000000000001111111111111111111111111111111111111111111111111111111111111111111111111
00000000000000000000000000000000000000000000000000000001111111111111111111111111111111111111111111111111111111111111111111111111
00000000000000000000000000000000000000000000000000000001111111111111111111111111111111111111111111111111111111111111111111111111
00000000000000000000000000000000000000000000000000000001111111111111111111111111111111111111111111111111111111111111111111111111
00000000000000000000000000000000000000000000000000000000111111111111111111111111111111111111111111111111111111111111111111111111
00000000000000000000000000000000000000000000000000000000011111111111111111111111111111111111111111111111111111111111111111111111
00000000000000000000000000000000000000000000000000000000111111111111111111111111111111111111111111111111111111111111111111111111
00000000000000000000000000000000000000000000000000000000111111111111111111111111111111111111111111111111111111111111111111111111
00000000000000000000000000000000000000000000000000000000111111111111111111111111111111111111111111111111111111111111111111111111
00000000011110100000000000000000000000000000000000000000111111111111111111111111111111111111111111111111111111111111111111111111
00000000111111100000000000000000000000000000000000000011111111111111111111111111111111110011111111111111101111111111111111111111
00000011111111100000000000000000000000000000000000000111111111111111111111111111111111100000111111111110000011111111111111111111
01000111111111111000000000000000000000000000000010011111111111111111111111111111111100000000011111110000000001111111111111111111
11001111111111111110000000000000000000000000000011111111111111111111111111111111111000000000000111000000000000111111111111111111
11111111111111111111110000000000000000000000000111111111111111111111111111111111111000000000000010000000000000011111111111111111
11111111111111111111111000000000000000000000001111111111111111111111111111111111110000000000000000000000000000011111111111111111
11111111111111111111111000000000000000000000001111111111111111111111111111111111110000000000000000000000000000011111111111111111
11111111111111111111111100000000000000000000001111111111111111111111111111111111100000000000000000000000000000000111111111111111
11111111111111111111111000000000000000000000001111111111111111111111111111111111100000000000000000000000000000000000111111111111
11111111111111111111111000000000000000000000001111111111111111111111111111111111100000000000000000000000000000000000001111111111
11111111111111111111111100000000000000000000001111111111111111111111111111111111100000000000000000000000000000000000000111111111
11111111111111111111111100000000000000000000001111111111111111111111111111111111000000000000000000000000000000000000000011111111
11111111111111111111111110000000000000000000001111111111111111111111111111111111000000000000000000000000000000000000000001111111
11111111111111111111111110000000000000000000001111111111111111111111111111111111000000000000000000000000000000000000000000011000
11111111111111111111111100000000000000000000001111111111111111111111111111111111000000000000000000000000000000000000000000000000
11111111111111111110011110000000000000000000001111111111111111111111111111111111100000000000000000000000000000000000000000000000
11111111111111111110011110000000000000000001001111111111111111111111111111111111110000000000000000000000000000000000000000000000
11111111111111111111011111110000001000000111101111111111111111111111111111111111110000000000000000000000000000000000000000000000
11111111111111111111111111110000011110011111111111111111111111111111111111111111100000000000000000000000000000000000000000000000
11111111111111111111111111111011111111111111111111111111111111111111111111111111110000000000000000000000000000000000000000000000
11111111111111111111111111111111111111111111111111111111111111111111111111111111100000000000000000000000000000000000000000000000
11111111111111111111111111111111111111111111111111111111111111111111111111111111100000000000000000000000000000000000000000000000
11111111111111111111111111111111111111111111111111111111111111111111111111111111000000000000000000000000000000000000000000000000
11111111111111111111111111111111111111111111111111111111111111111111111111111100000000000000000000000000000000000000000000000000
11111111111111111111111111111111111111111111111111111111111111111111111111111000000000000000000000000000000000000000000000000000
11111111111111111111111111111111111111111111111111111111111111111111111111110000000000000000000000000000000000000000000000000000
11111111111111111111111111111111111111111111111111111111111111111111111111110000000000000000000000000000000000000000000000000000
11111111111111111111111111111111111111111111111111111111111111111111111111100000000000000000000000000000000000000000000000000000
11111111111111111111111111111111111111111111111111111111111111111111111111100000000000000000000000000000000000000000000000000000
11111111111111111111111111111111111111111111111111111111111111111111111111100000000000000000000000000000000000000000000000000000
