00000000000000000000000000000000000000000000000000000000000000010111111111111111111111111111111111111111111111111111111111111111
00000000000000000000000000000000000000000000000000000000000000011111111111111111111111111111111111111111111111111111111111111111
00000000000000000000000000000000000000000000000000000000000000111001111111111111111111111111111111111111111111111111111111111111
00000000000000000000000000000000000000000000000000000000000000111001111111111111111111111111111111111111111111111111111111111111
00000000000000000000000000000000000000000000000000000000000000000000111111111111111111111111111111111111111111111111111111111111
00000000000000000000000000000000000000000000000000000000000000000000111111111111111111111111111111111111111111111111111111111111
00000000000000000000000000000000000000000000000000000000000000000000011111111111111111111111111111111111111111111111111111111111
00000000000000000000000000000000000000000000000000000000000000000000000111111111111111111111111111111111111111111111111100011111
00000000000000000000000000000000000000000000000000000000000000000000001111111111111111111111111111111111111111111111100000000000
00000000000000000000000000000000000000000000000000000000000000000000011111111111111111111111111111111111111111111110000000000000
00000000000000000000000000000000000000000000000000000000000000000000011111111111111111111111111111111111111111111110000000000000
00000000000000000000000000000000000000000000000000000000000000000000010111111111111111111111111111111111111111111000000000000000
00000000000000000000000000000000000000000000000000000000000000000000000011111111111111111111111111111111111111100000000000000000
00000000000000000000000000000000000000000000000000000000000000000000000011111111111111111111111111111111111111100000000000000000
00000000000000000000000000000000000000000000000000000000000000000000000011111111111111111111111111111111111111000000000000000000
00000000000000000000000000000000000000000000000000000000000000000000000001111111111111111111111111111111111100000000000000000000
00000000000000000000000000000000000000000000000000000000000000000000000000111111111111111111111111111111110000000000000000000000
00000000000000000000000000000000000000000000000000000000000000000000000000011111111111111111111111111111000000000000000000000000
00000000000000000000000000000000000000000000000000000000000000000000000000011111111111111111111111111000000000000000000000000000
00000000000000000000000000000000000000000000000000000000000000000000000000011111111111111111111111111000000000000000000000000000
00000000000000000000000000000000000000000000000000000000000000000000000000000011111111111111111111100000000000000000000000000000
00001111110000000000000000000000000000000000000000000000000000000000000000000011111111111111111111000000000000000000000000000000
00001111111000000000000000000000000000000000000000000000000000000000000000000001111111111111111111000000000000000000000000000000
00001111111111100000000000000000000000000000000000000000000000000000000000000000111111111111111110000000000000000000000000000000
00000111111111111000000000000000000000000000000000000000000000000000000000000000111111001111111100000000000000000000000000000000
00000111111111111100000000000000000000000000000000000000000000000000000000000000111111001111111100000000000000000000000000000000
00001111111111111110000000000000000000000000000000000000000000000000000000000000011111000111110000000000000000000000000000000000
00001111111111111111111111100000000000000000000000000000011111000000000000000000001111100111100000000000000000000000000000000000
00001111111111111111111111110000000000000000000000000000111111110000000000000000001110000000000000000000000000000000000000000000
00000111111111111111111111111111000000000000000000000000111111110000000000000000010011000000000000000000000000000000000000000000
00001111111111111111111111111111100000000000000000000000111111110000000000000000000000000000000000000000000000000000000000000000
00001111111111111111111111111111100000000000000000000001111111110000000000000000000010000000000000000000000000000000000000000000
01111111111111111111111111111111000000000001110001100001111111110000000000000000011110000000000000000000000000000000000000000000
11111111111111111111111111111111000000111111111111100011111111110000000000000000111110000000000000000000000000000000000000000000
11111111111111111111111111111111100111111111111111111111111111111100000000010011111110000000000000000000000000000000000000000000
11111111111111111111111111111111110111111111111111111111111111111100011111111111111110000000000000000000000000000000000000000000
11111111111111111111111111111111111111111111111111111111111111111111111111111111111100000000000000000000000000000000000000000000
11111111111111111111111111111111111111111111111111111111111111111111111111111111111000000000000000000000000000000000000000000000
11111111111111111111111111111111111111111111111111111111111111111111111111111111111100000000000000000000000000000000000000000000
11111111111111111111111111111111111111111111111111111111111111111111111111111111111100000000000000000000000000000000000000000000
11111111111111111111111111111111111111111111111111111111111111111111111111111111111111000000000000000000000000000000000000000000
01111111111111111111111111111111111111111111111111111111111111111111111111111111111111100000000000000000000000000000000000000000
00111111111111111111111111111111111111111111111111111111111111111111111111111111111111110000000000000000000000000000000000000000
00011111111111111111111111111111111111111111111111111111111111111111111111111111111111000000000000000000000000000000000000000000
00011111111111111111111111111111111111111111111111111111111111111111111111111111111111000000000000000000000000000000000000000000
00011111111111111111111111111111111111111111111111111111111111111111111111111111111110000000000000000000000000000000000000000000
00011111111111111111111111111111111111111111111111111111111111111111111111111111111110000000000000000000000000000000000000000000
00011111111111111111111111111111111111111111111111111111111111111111111111111111111100000000000000000000000000000000000000000000
00001111111111111111111111111111111111111111111111111111111111111111111111111111111000000000000000000000000000000000000000000000
00000111111111111111111111111111111111111111111111111111111111111111111111111111111000000000000000000000000000000000000000000000
00001111111111111111111111111111111111111111111111111111111111111111111111111111100000000000000000000000000000000000000000000000
00001111111111111111111111111111111111111111111111111111111111111111111111111111000000000000000000000000000000000011110000000000
00001111111111111111111111111111111111111111111111111111111111111111111111111100000000000000000000000000000000001111111111100000
00001111111111111111111111111111111111111111111111111111111111111111111111111100000000000000000000000000000000011111111111100000
00001111111111111111111111111111111111111111111111111111111111111111111111111100000000000000000000000000000000011111111111110000
00001111111111111111111111111111111111111111111111111111111111111111111111110000000000000000000000000000000000011111111111111100
00000111111111111111111111111111111111111111111111111111111111111111111111100000000000000000000000000000000000011111111111111110
00000011111111111111111111111111111111111111111111111111111111111111110000000000000000000000000000000000000000011111111111111111
00000001111111111111111111111111111111111111111111111111111111111111110000000000000000000000000000000000000011111111111111111111
00000001111111111111111111111111111111111111111111111111111111111111110000000000000000000000000000000000000011111111111111111111
00000001111111111111111111111111111111111111111111111111111111111111111000000000000000000000000000000000001000111111111111111111
00000001111111111111111111111111111111111111111111111111111111111111111100000000000000000000000000000000001000111111111111111111
00000011111111111111111111111111111111111111111111111111111111111111100100000000000000000000000000000000000001111111111111111111
00110011111111111111111111111111111111111111111111111111111111111100000000000000000000010000000000111000000011111111111111111111
00111111111111111111111111111111111111111111111111111111111111110000000000000000000000111110000100111000000001111111111111111111
11111111111111111111111111111111111111111111111111111111111111000000000000000001111011111111111111111000000001111111111111111111
11111111111111111111111111111111111111111111111111111111100000000000000000000011111111111111111111111000000001111111111111111111
11111111111111111111111111111111111111111111111111111100000000000000000000000111111111111111111111111000000001111111111111111111
11111111111111111111111111111111111111111111111111111100000000000000000000001111111111111111111111111100000001111111111111111111
11111111111111111111111111111111111111111111111111111000000000000000000000011111111111111111111001111100000001111111111111111111
11111111111111111111111111111111111111111111111111100000000000000000000000000111111111111111111001111110000001111111111111111111
11111111111111111111111111111111111111111111111111000000000000000000000000000011111111111111111011111111000011111111111111111111
11111111111111111111111111111111111111111111111111100000000000000000000000000010011000111111111111111111100011111111111111111111
11111111111111111111111111111111111111111111111111100000010000000000000000000000000000011111111111111111100111111111111111111111
11111111111111111111111111111111111111111111111111100000000000000000000000000000000000011111111111111111111111111111111111111111
11111111111111111111111111111111111111111111111111100000000000000000000000000000000000001111111111111111111111111111111111111111
00011111111111111111111111111111111111111111111111000000000000000000000000000000000000000111111111111111111111111111111111111111
00011111111111111111111111111111111111111111111111000000000000000000000000000000000000000111110000111111111111111111111111111111
00000111111111111111111111111111111111111111111111000000000000000000000000000000000000000011100000001111111111111111111111111111
00000011111111111111111111111111111111111111111111100000000000000000000000000000000000000011111000000111111111111111111111111111
00000001111111111111111111111111111111111111111111100000000000000000000000000000000000000011111000001111111111111111111111111111
00000000111111111111111111111111111111111111111111110000000000000000000000000000000000000011111111001111111111111111111111111111
00000000011111111111111111111111111111111111111111110000000000000000000000000000000000000001111111111111111111111111111111111111
00000000001111111111111111111111111111111111111111110000000000000000000000000000000000000001111111111111111111111111111111111111
00000000001111111111111111111111111111111111111111110000000000000000000000000000000000000001111111111111111111111111111111111111
00000000001111111111111111111111111111111111111011100000000000000000000000000000000000000001111111111111111111111111111111111111
00000000001111111111111111111111111111111111110000000000000000000000000000000000000000000001111111111111111111111111111111111111
00000000000111111111111111111111111111111111110000000000000000000000000000000000000000000001111111111111111111111111111111111111
00000000000011111111111111111111111111111111111111111100000000000000000000000000000000000011111111111111111111111111111111111111
00000000000001111111111111111111111111111111111111111110000000000000000000000000000000000011111111111111111111111111111111111111
00000000000001111111111111111111111111111111111111111111100000000000000000000000000000000111111111111111111111111111111111111111
00000000000001111111111111111111111111111111111111111111110000000000000000000000000000000111111111111111111111111111111111111111
00000000000000111111111111111111111111111111111111111111111000000000000000000000000000000111111111111111111111111111111111111111
00000000000000111111111111111111111111111111111111111111111000000000000000000000000000000111111111111111111111111111111111111111
00000000000001111111111111111111111111111111111111111111111111000000000000000000000000000111111111111111111111111111111111111111
00000000000000111111111111111111111111111111111111111111111111100000000000000000000000000001111111111111111111111111111111111111
00000000000000000011111111111111111111111111111111111111111111110000000000000000000000000000111111111111111111111111111111111111
00000000000000000001001111111111111111111111111111111111111111111100000000000000000000000000111111111111111111111111111111111111
00000000000000000000001111111111111111111111111111111111111111111110000000000000000000000001111111111111111111111111111111111111
00000000000000000000000111111111111111111111111111111111111111111111000000000000000000000011001111111111111111111111111111111111
00000000000000000000000001111111111111111111111111111111111111111111000000000000000000000011111111111111111111111111111111111111
00000000000000000000000000011111111111111111111111111111111111111111100000000000000000001111111111111111111111111111111111111111
00000000000000000001000000011111111111111111111111111111111111111111100000000000000000011111111111111111111111111111111111111111
00000000000000000001000001111111111111111111111111111111111111111111110000000000000000001111111111111111111111111111111111111111
00000000000000000000000111111111111111111111111111111111111111111111110000000000000000001111111111111111111111111111111111111111
00000000000000000000000111111111111111111111111111111111111111111111111000000000000000000111111111111111111111111111111111111111
00000000000000000000011111111111111111111111111111111111111111111111111100000000000000000111111111111111111111111111111111111111
00000000000000000000111111111111111111111111111111111111111111111111111110000000000000000111111111111111111111111111111111111111
00000000000000000000111111111111111111111111111111111111111111111111111100000000000000000111111111111111111111111111111111111111
00000000000000000000111110011111111111111111111111111111111111111111111000000000001100000111111111111111111111111111111111111111
00000000000000000000000100001111111001111111111111111111111111111111100000000000000000000111111111111111111111111111111111111111
00000000000000000000000000000111110001111111111111111111111111111111000000000000000000001111111111111111111111111111111111111111
00000000000000000000000000000011000000111111111111111111111111111110000000000000000001111111111111111111111111111111111111111111
00000000000000000000000000000000000000111111111111111111111111111100000000000000000001111111111111111111111111111111111111111111
00000000000000000000000000000000000000111111111111111111111111111000000000000000000000111111111111111111111111111111111111111111
00000000000000000000000000000000000000111111111111111111111111111000000000000000000000000011111111111111111111111111111111111111
00000000000000000000000000000000000001111111111111111111111111110000000000000000000000000000111111111111111111111111111111111111
00000000000000000000000000000000000011111111111111111111111111110000000000000000000000000000011111111111111111111111111111111111
00000000000000000000000000011100000111111111111111111111111111110000000000000000000000000000000001111111111111111111111111111111
00000000000000000000000000011111111111111111111111111111111111111000000000000000000000000000000000111111111111111111111111111111
00000000000000000000000000111111111111111111111111111111111111111100000000000000000000000000000000000011111111111111111111111111
00000000000000000000000011111111111111111111111111111111111111111100000000000000000000000000000000000001111111111111111111111111
00000000000000000000000111111111111111111111111111111111111111111111000000000000000000000000000000000000111111111111111111111111
00000000000000000000000111111111111111111111111111111111111111111111000000000000000000000000000000000000011111111111111111111111
00000000000000000011111111111111111111111111111111111111111111111111000000000000000000000000000000000000001111111111111111111111
00000000000000000111111111111111111111111111111111111111111111111110000000000000000000000000000000000000000000011111111111111111
00000000000000001111111111111111111111111111111111111111111111111110000000000000000000000000000000000000000000011111111111111111
00000000000000011111111111111111111111111111111111111111111111111000000000000000000000000000000000000000000000000001111111111111
